8 8
# bloqueado
_ libre
_#___#__
_#_#____
___#####
#_######
___#___#
___#_#__
#__#_#__
#____#__