8 8
_#___#_#
_#_#____
___#####
#_######
___#___#
___#_#__
#__#_#__
#____#__